3 1 1 1 1 1 1 0 1 1 1 1 1 1 7
2 4 6 6 6 6 6 0 6 6 6 6 6 9 8
2 5 0 0 0 0 0 0 0 0 0 0 0 10 8
2 5 0 0 0 0 0 0 0 0 0 0 0 10 8
0 0 0 0 0 0 0 0 0 0 0 0 0 0 0
2 5 0 0 0 0 0 0 0 0 0 0 0 10 8
2 5 0 0 0 0 0 0 0 0 0 0 0 10 8
2 12 13 13 13 13 13 0 13 13 13 13 13 14 8
11 16 16 16 16 16 16 0 16 16 16 16 16 16 15 16 16 16 16 16 16 16 16 16 15



